border_size=1
usage=map

Aa^Fpa      , Aa          , Aa^Fpa      , Aa          , Re          , Aa          , Aa          , Aa          , Aa          , Ai          , Wo          , Ai          , Ai          , Ai          , Wo          , Wo          , Wo          , Wo          , Wo          , Wo          , Aa          , Aa          , Aa          , Ai          , Ai          , Wo          , Wo          , Wo          , Ai          , Mm^Xm       , Mm^Xm       , Mm^Xm       , Aa^Fpa      , Aa          , Aa          , Aa          , Re          
Aa^Fpa      , Aa^Fpa      , Ha^Vhha     , Aa          , Re          , Chr         , Chr         , Chr         , Aa          , Aa^Vha      , Wo          , Ai          , Ai          , Wo          , Wo          , Wo          , Wo          , Wo          , Wo          , Aa          , Ch          , Ch          , Ch          , Ai          , Wo          , Wo          , Wo          , Wo          , Ai          , Mm^Xm       , Mm^Xm       , Mm^Xm       , Aa^Fpa      , Aa^Vea      , Aa          , Re          , Aa          
Aa^Fpa      , Aa^Fpa      , Aa^Fpa      , Aa^Fpa      , Re          , Chr         , 1 Khr       , Chr         , Aa          , Wo          , Ai          , Ai          , Wo          , Wo          , Wo          , Wo          , Wo          , Wo          , Wo          , Aa^Fpa      , Aa          , 5 Kh        , Ai          , Ai          , Wo          , Wo          , Ai          , Ai          , Wo          , Mm^Xm       , Mm^Xm       , Mm^Xm       , Mm^Xm       , Aa^Fpa      , Aa          , Re          , Aa          
Aa          , Aa^Fpa      , Aa^Fpa      , Aa^Fpa      , Aa^Fpa      , Re          , Aa          , Chr         , Aa^Fpa      , Aa          , Ai          , Ai          , Ai          , Wo          , Wo          , Wo          , Wo          , Wo          , Wo          , Aa^Vha      , Ai          , Ai          , Wo          , Wo          , Wo          , Wo          , Ai          , Wo          , Wo          , Aa          , Aa          , Mm^Xm       , Mm^Xm       , Aa^Fpa      , Aa^Fpa      , Re          , Aa          
Aa          , Aa^Fpa      , Ha^Vhha     , Aa^Fpa      , Aa^Fpa      , Re          , Aa^Fpa      , Aa          , Aa^Fpa      , Aa          , Wo          , Ai          , Wo          , Wo          , Wo          , Wo          , Wo          , Wo          , Wo          , Wo          , Wo          , Wo          , Wo          , Wo          , Wo          , Wo          , Wo          , Aa          , Aa          , Aa          , Aa^Fpa      , Mm^Xm       , Mm^Xm       , Aa^Fpa      , Aa          , Re          , Aa          
Aa          , Aa^Fpa      , Ha          , Ha          , Aa^Fpa      , Re          , Aa^Fpa      , Aa          , Aa          , Aa^Fpa      , Wo          , Ai          , Ai          , Wo          , Wo          , Wo          , Wo          , Wo          , Wo          , Wo          , Wo          , Wo          , Wo          , Wo          , Wo          , Ai          , Aa          , Aa          , Aa          , Aa^Fpa      , Aa          , Mm^Xm       , Chr         , Mm^Xm       , Mm^Xm       , Re          , Aa          
Aa          , Aa^Fpa      , Ha          , Ha          , Ha          , Re          , Re          , Aa          , Aa^Fpa      , Aa^Vha      , Aa          , Ai          , Ai          , Wo          , Wo          , Wo          , Wo          , Wo          , Wo          , Wo          , Wo          , Wo          , Wo          , Wo          , Ai          , Ai          , Aa          , Aa^Fpa      , Aa^Fpa      , Aa^Fpa      , Aa          , Chr         , Chr         , Mm^Xm       , Re          , Re          , Aa          
Aa          , Ha          , Ha          , Ha          , Ha          , Ha          , Re          , Aa          , Aa^Fpa      , Aa^Fpa      , Aa^Fpa      , Ai          , Ai          , Ai          , Wo          , Wo          , Wo          , Wo          , Wo          , Wo          , Wo          , Wo          , Wo          , Wo          , Wo          , Wo          , Aa^Fpa      , Aa^Fpa      , Aa^Fpa      , Aa          , Aa          , Chr         , 8 Khr       , Chr         , Re          , Mm^Xm       , Aa          
Aa          , Ha          , Ha          , Ha          , Ha          , Ha          , Ha          , Re          , Aa          , Aa^Fpa      , Aa^Fpa      , Aa          , Aa          , Ai          , Wo          , Wo          , Wo          , Wo          , Wo          , Wo          , Wo          , Wo          , Wo          , Ai          , Ai          , Aa          , Aa^Fpa      , Aa^Fpa      , Aa^Fpa      , Aa          , Aa          , Chr         , Chr         , Chr         , Re          , Mm^Xm       , Aa          
Re          , Re          , Re          , Ha          , Ha          , Ha^Vhha     , Re          , Re          , Ce          , Aa          , Aa^Vea      , Aa          , Ai          , Ai          , Wo          , Wo          , Wo          , Wo          , Wo          , Wo          , Wo          , Wo          , Wo          , Ai          , Ai          , Aa          , Aa^Fpa      , Aa          , Aa          , Aa          , Aa          , Aa          , Re          , Re          , Mm^Xm       , Mm^Xm       , Aa          
Aa          , Aa          , Aa          , Re          , Re          , Re          , Re          , Ce          , 3 Ke        , Ce          , Wo          , Wo          , Ai          , Wo          , Wo          , Wo          , Wo          , Wo          , Wo          , Wo          , Wo          , Wo          , Wo          , Wo          , Wo          , Aa          , Aa          , Aa          , Aa          , Aa          , Aa          , Aa          , Re          , Mm^Xm       , Mm^Xm       , Mm^Xm       , Aa          
Aa          , Aa          , Aa^Fpa      , Aa          , Aa          , Aa          , Re          , Ce          , Ce          , Ce          , Wo          , Ai          , Wo          , Wo          , Wo          , Wo          , Wo          , Wo          , Wo          , Wo          , Wo          , Wo          , Wo          , Wo          , Ai          , Aa          , Aa          , Aa          , Aa^Fpa      , Aa          , Aa^Vea      , Re          , Ai          , Ai          , Ai          , Mm^Xm       , Aa          
Aa          , Aa          , Aa^Fpa      , Aa^Fpa      , Aa^Fpa      , Aa^Fpa      , Aa          , Re          , Ai          , Ai          , Ai          , Ai          , Ai          , Wo          , Wo          , Wo          , Wo          , Wo          , Wo          , Wo          , Wo          , Wo          , Wo          , Ai          , Wo          , Aa          , Aa          , Aa^Fpa      , Aa^Fpa      , Aa          , Aa          , Re          , Ai          , Ai          , Ai          , Ai          , Aa          
Aa          , Aa          , Chr         , Chr         , Chr         , Aa          , Re          , Re          , Ai          , Ai          , Ai          , Wo          , Wo          , Wo          , Wo          , Wo          , Wo          , Wo          , Wo          , Wo          , Wo          , Wo          , Ai          , Ai          , Aa          , Aa          , Aa          , Aa^Fpa      , Re          , Aa          , Re          , Re          , Re          , Ai          , Re          , Re          , Aa          
Aa          , Aa          , Chr         , 4 Khr       , Chr         , Aa          , Re          , Ai          , Ai          , Ai          , Ai          , Ai          , Wo          , Ai          , Wo          , Wo          , Wo          , Wo          , Wo          , Wo          , Wo          , Wo          , Ai          , Wo          , Ai          , Re          , Re          , Re          , Aa^Fpa      , Re          , Re          , Aa          , Aa          , Re          , Aa          , Aa          , Aa          
Aa          , Aa^Fpa      , Aa^Fpa      , Chr         , Aa^Fpa      , Aa          , Re          , Ai          , Ai          , Ai          , Ai          , Ai          , Ai          , Ai          , Ai          , Wo          , Wo          , Wo          , Wo          , Wo          , Wo          , Wo          , Wo          , Ai          , Ai          , Aa^Vha      , Aa          , Aa          , Aa^Fpa      , Aa^Fpa      , Re          , Aa          , Aa          , Aa          , Aa^Fpa      , Aa^Fpa      , Aa          
Aa^Fpa      , Aa          , Aa^Fpa      , Aa          , Ai          , Aa          , Re          , Ai          , Aa          , Ai          , Ai          , Ai          , Aa^Vea      , Wo          , Ai          , Ai          , Wo          , Wo          , Wo          , Wo          , Wo          , Wo          , Wo          , Ai          , Ai          , Aa          , Aa          , Aa^Fpa      , Aa^Fpa      , Aa^Fpa      , Re          , Chr         , Chr         , Aa          , Aa^Fpa      , Aa^Fpa      , Aa          
Aa^Fpa      , Aa          , Aa^Vha      , Ai          , Ai          , Ai          , Aa          , Re          , Aa          , Aa          , Aa          , Aa          , Re          , Re          , Wo          , Wo          , Wo          , Wo          , Wo          , Wo          , Wo          , Wo          , Wo          , Wo          , Ai          , Ai          , Aa          , Aa^Fpa      , Aa^Fpa      , Aa^Fpa      , Re          , Chr         , Chr         , Aa          , Aa          , Aa          , Aa          
Aa          , Aa^Fpa      , Aa          , Aa          , Aa          , Ai          , Aa          , Re          , Re          , Re          , Re          , Re          , Aa^Fpa      , Aa^Fpa      , Ai          , Wo          , Wo          , Wo          , Wo          , Wo          , Wo          , Wo          , Wo          , Wo          , Ai          , Ai          , Ai          , Aa          , Aa          , Aa          , Re          , 7 Khr       , Chr         , Chr         , Aa^Fpa      , Aa          , Aa          
Aa          , Aa^Fpa      , Aa^Fpa      , Aa^Fpa      , Aa          , Aa          , Aa          , Re          , Re          , Aa^Vha      , Aa          , Aa^Fpa      , Aa^Fpa      , Aa          , Wo          , Ai          , Wo          , Wo          , Wo          , Wo          , Wo          , Wo          , Wo          , Wo          , Wo          , Ai          , Aa          , Aa          , Aa^Vha      , Aa          , Re          , Chr         , Chr         , Aa^Fpa      , Aa^Fpa      , Aa^Fpa      , Aa          
Aa          , Aa^Fpa      , Aa^Vea      , Aa          , Aa^Fpa      , Aa          , Re          , Re          , Ai          , Ai          , Aa^Fpa      , Aa^Fpa      , Aa          , Aa          , Ai          , Wo          , Wo          , Wo          , Wo          , Wo          , Wo          , Wo          , Wo          , Wo          , Wo          , Ai          , Aa          , Aa          , Aa^Fpa      , Aa          , Aa          , Re          , Aa          , Aa^Fpa      , Ha          , Ha          , Aa          
Aa          , Aa^Fpa      , Aa          , Aa          , Re          , Re          , Aa          , Aa          , Ai          , Ai          , Aa^Fpa      , Aa^Fpa      , Ai          , Wo          , Ai          , Wo          , Wo          , Wo          , Wo          , Wo          , Wo          , Wo          , Wo          , Wo          , Wo          , Ai          , Aa          , Aa          , Aa^Fpa      , Aa^Fpa      , Aa          , Re          , Aa          , Aa^Fpa      , Ha          , Ha          , Aa          
Aa          , Aa          , Aa          , Aa          , Re          , Re          , Aa          , Aa          , Aa          , Aa          , Aa          , Aa          , Ai          , Ai          , Wo          , Wo          , Wo          , Wo          , Wo          , Wo          , Ai          , Wo          , Wo          , Wo          , Wo          , Ai          , Aa          , Aa^Fpa      , Aa^Fpa      , Aa^Fpa      , Aa          , Re          , Aa          , Aa          , Ha          , Ha          , Aa          
Aa          , Aa          , Aa          , Aa          , Re          , Re          , 2 Khr       , Chr         , Chr         , Aa          , Aa^Vea      , Ai          , Ai          , Wo          , Wo          , Wo          , Wo          , Wo          , Wo          , 6 Kh        , Ch          , Ai          , Wo          , Wo          , Wo          , Wo          , Aa          , Aa          , Aa^Fpa      , Aa^Fpa      , Aa          , Re          , Re          , Aa          , Ha          , Ha^Vhha     , Aa          
Aa          , Aa^Fpa      , Aa^Fpa      , Aa          , Re          , Re          , Chr         , Chr         , Chr         , Aa          , Ai          , Ai          , Wo          , Wo          , Wo          , Wo          , Wo          , Wo          , Wo          , Ch          , Aa          , Aa^Fpa      , Ai          , Wo          , Wo          , Wo          , Wo          , Aa          , Aa          , Aa^Fpa      , Aa^Vea      , Aa          , Re          , Ha          , Ha          , Ha          , Ha          
Aa          , Aa^Fpa      , Aa^Fpa      , Aa          , Re          , Re          , Aa^Fpa      , Chr         , Aa          , Ai          , Wo          , Wo          , Wo          , Wo          , Wo          , Wo          , Wo          , Wo          , Ai          , Aa^Vea      , Aa          , Aa^Fpa      , Ai          , Wo          , Wo          , Wo          , Wo          , Ai          , Wo          , Aa          , Aa          , Aa          , Re          , Ha          , Ha          , Ha          , Ha          
Aa          , Aa^Fpa      , Aa          , Aa^Fpa      , Re          , Re          , Aa          , Aa          , Aa          , Ai          , Ai          , Wo          , Wo          , Wo          , Wo          , Wo          , Wo          , Wo          , Wo          , Ai          , Wo          , Ai          , Wo          , Wo          , Wo          , Wo          , Wo          , Wo          , Wo          , Aa          , Aa          , Aa          , Re          , Ha          , Aa          , Ha          , Aa          
