border_size=1
usage=map

Md^Xm       , Md^Xm       , Md^Xm       , Md^Xm       , Md^Xm       , Md^Xm       , Md^Xm       , Ds          , Md^Xm       , Ds          , Md^Xm       , Md^Xm       , Md^Xm       , Md^Xm       , Md^Xm       , Ds          , Md^Xm       , Md^Xm       , Md^Xm       , Ds          , Md^Xm       , Md^Xm       , Md^Xm       , Md^Xm       , Md^Xm       , Md^Xm       , Md^Xm       , Md^Xm       , Md^Xm       , Ds          , Ds          , Ds          , Md^Xm       , Md^Xm       , Md^Xm       , Md^Xm       , Md^Xm       , Md^Xm       , Md^Xm       , Ds          , Md^Xm       , Md^Xm       , Md^Xm       , Ds          , Md^Xm       , Ds          , Md^Xm       , Md^Xm       , Md^Xm       , Md^Xm       , Md^Xm       , Md^Xm       , Md^Xm       , Md^Xm       , Md^Xm       , Md^Xm       , Md^Xm       , Ds          , Md^Xm       , Ds          , Md^Xm       , Md^Xm       
Md^Xm       , Md^Xm       , Md^Xm       , Md^Xm       , Md^Xm       , Md^Xm       , Md^Xm       , Md^Xm       , Ds          , Md^Xm       , Ds          , Md^Xm       , Ds          , Md^Xm       , Md^Xm       , Md^Xm       , Md^Xm       , Md^Xm       , Ds          , Md^Xm       , Md^Xm       , Md^Xm       , Md^Xm       , Md^Xm       , Md^Xm       , Md^Xm       , Md^Xm       , Md^Xm       , Md^Xm       , Md^Xm       , Md^Xm       , Md^Xm       , Md^Xm       , Md^Xm       , Md^Xm       , Md^Xm       , Ds          , Md^Xm       , Md^Xm       , Md^Xm       , Md^Xm       , Md^Xm       , Ds          , Md^Xm       , Ds          , Md^Xm       , Ds          , Md^Xm       , Ds          , Md^Xm       , Dd          , Md^Xm       , Ds          , Ds          , Ds          , Md^Xm       , Ds          , Md^Xm       , Md^Xm       , Md^Xm       , Md^Xm       , Md^Xm       
Md^Xm       , Md^Xm       , Md^Xm       , Md^Xm       , Md^Xm       , Md^Xm       , Ds          , Ds          , Hd          , Ds          , Ds          , Ds          , Ds          , Ds          , Ds          , Ds          , Ds          , Ds          , Ds          , Ds          , Hd          , Ds          , Ds          , Md^Xm       , Ds          , Md^Xm       , Md^Xm       , Md^Xm       , Md^Xm       , Md^Xm       , Md^Xm       , Ds          , Ds          , Ds          , Ds          , Ds          , Ds          , Ds          , Ds          , Md^Xm       , Md^Xm       , Ds          , Ds          , Ds          , Ds          , Ds          , Ds          , Ds          , Ds          , Ds          , Dd          , Dd          , Dd          , Dd          , Ds          , Ds          , Ds          , Ds          , Ds          , Md^Xm       , Md^Xm       , Md^Xm       
Md^Xm       , Md^Xm       , Md^Xm       , Md^Xm       , Md^Xm       , Md^Xm       , Ds          , Hd          , Hd          , Hd          , Ds          , Ds          , Ds          , Ds          , Hd          , Ds          , Ds          , Ds          , Ds          , Ds          , Hd          , Ds          , Ds          , Ds          , Ds          , Md^Xm       , Ds          , Ds          , Ds          , Md^Xm       , Ds          , Ds          , Ds          , Ds          , Ds          , Ds          , Dd          , Dd          , Ds          , Ds          , Ds          , Ds          , Ds          , Ds          , Hd          , Ds          , Ds          , Ds          , Ds          , Dd          , Dd          , Dd          , Dd          , Dd          , Dd          , Ds          , Ds          , Ds          , Ds          , Ds          , Md^Xm       , Md^Xm       
Md^Xm       , Md^Xm       , Md^Xm       , Md^Xm       , Ds          , Ds          , Ds          , Hd          , Hd          , Ds          , Dd          , Ds          , Hd          , Ds          , Ds          , Ds          , Ds          , Dd^Vda      , Ds          , Ds          , Hd          , Ds          , Ds          , Ds          , Ds          , Ds          , Ds          , Ds          , Ds          , Ds          , Hd          , Hd          , Hd          , Hd          , Dd          , Dd          , Dd          , Dd          , Ds          , Ds          , Dd          , Dd          , Dd          , Ds          , Ds          , Hd          , Hd          , Hd          , Ds          , Dd          , Dd          , Dd          , Dd          , Dd          , Hd          , Ds          , Hd          , Ds          , Ds          , Ds          , Ds          , Md^Xm       
Md^Xm       , Md^Xm       , Md^Xm       , Md^Xm       , Ds          , Ds          , Ds          , Hd          , Ds          , Ds          , Dd          , Dd          , Dd          , Hd          , Ds          , Dd          , Dd          , Dd          , Hd          , Hd          , Gg          , Gs          , Gs^Ft       , Gs          , Dd^Cd       , Ds          , Ds          , Ds          , Ds          , Hd          , Hd          , Hd          , Hd          , Hd          , Dd          , Dd          , Dd          , Dd          , Ds          , Ds          , Dd          , Dd          , Dd          , Dd          , Ds          , Hd          , Hd          , Hd          , Hd          , Ds          , Ds          , Dd          , Ds          , Ds          , Ds          , Hd          , Hd          , Hd          , Ds          , Dd          , Dd          , Md^Xm       
Md^Xm       , Md^Xm       , Md^Xm       , Md^Xm       , Ds          , Ds          , Ds          , Ds          , Ds          , Ds          , Dd          , Dd          , Hd          , Hd          , Ds          , Ds          , Hd          , Dd          , Dd^Fi       , Ww          , Ww          , Ww          , Ww          , Gs^Ft       , Dd^Cd       , Ds          , Ds          , Ds          , Dd          , Dd          , Dd          , Hd          , Ds          , Ds          , Ds          , Dd          , Ds          , Ds          , Ds          , Dd          , Dd^Do       , Dd          , Dd          , Dd          , Ds          , Hd          , Hd          , Hd          , Ds          , Ds          , Ds          , Ds          , Ds          , Ds          , Hd          , Hd          , Hd          , Hd          , Ds          , Dd          , Dd          , Md^Xm       
Md^Xm       , Md^Xm       , Md^Xm       , Md^Xm       , Ds          , Ds          , Ds          , Dd          , Dd          , Dd          , Dd^Do       , Ds          , Ds          , Ds          , Hd          , Ds          , Ds          , Hd          , Ds          , Ww          , Ww          , Ww          , Dd^Cd       , 3 Dd^Kd     , Dd^Cd       , Dd^Vdt      , Ds          , Ds          , Dd          , Dd          , Dd          , Dd          , Ds          , Ds          , Ds          , Ds          , Ds          , Ds          , Hd          , Ds          , Ds          , Ds          , Ds          , Ds          , Ds          , Ds          , Ds          , Ds          , Ds          , Ds          , Dd          , Dd          , Dd          , Ds          , Hd          , Hd          , Hd          , Hd          , Ds          , Dd          , Ds          , Md^Xm       
Md^Xm       , Md^Xm       , Md^Xm       , Md^Xm       , Md^Xm       , Ds          , Ds          , Dd          , Dd          , Dd          , Dd          , Ds          , Hd          , Hd          , Hd          , Ds          , Ds          , Hd          , Ds          , Ds          , Ds          , Dd^Cd       , Ds          , Dd^Cd       , Ds          , Ds          , Ds          , Ds          , Ds          , Dd          , Dd          , Dd          , Ds          , Ds          , Ds          , Ds          , Hd          , Hd          , Hd          , Ds          , Ds          , Ds          , Dd          , Ds          , Ds          , Ds          , Ds          , Ds          , Dd          , Dd          , Dd          , Dd          , Dd          , Ds          , Dd^Do       , Ds          , Ds          , Ds          , Ds          , Dd          , Ds          , Md^Xm       
Md^Xm       , Md^Xm       , Md^Xm       , Md^Xm       , Md^Xm       , Md^Xm       , Ds          , Ds          , Dd          , Dd          , Dd          , Ds          , Hd          , Ds          , Dd          , Ds          , Ds          , Dd          , Dd          , Ds          , Dd^Vda      , Ds          , Ds          , Ds          , Ds          , Ds          , Ds          , Ds          , Ds          , Dd          , Ds          , Dd          , Ds          , Ds          , Ds          , Hd          , Hd          , Hd          , Hd          , Ds          , Ds          , Ds          , Dd          , Dd          , Dd          , Ds          , Ds          , Ds          , Dd          , Dd          , Dd          , Dd          , Ds          , Ds          , Ds          , Ds          , Ds          , Ds          , Ds          , Ds          , Md^Xm       , Md^Xm       
Md^Xm       , Md^Xm       , Md^Xm       , Md^Xm       , Md^Xm       , Ds          , Ds          , Ds          , Ds          , Ds          , Ds          , Dd          , Dd          , Dd          , Dd          , Ds          , Ds          , Dd          , Dd          , Ds          , Ds          , Ds          , Ds          , Ds          , Ds          , Ds          , Md^Xm       , Md^Xm       , Md^Xm       , Ds          , Ds          , Ds          , Ds          , Ds          , Ds          , Hd          , Hd          , Hd          , Ds          , Ds          , Ds          , Dd          , Dd          , Dd          , Dd          , Dd          , Ds          , Ds          , Ds          , Ds          , Dd          , Ds          , Ds          , Ds          , Ds          , Dd          , Ds          , Ds          , Ds          , Ds          , Md^Xm       , Md^Xm       
Md^Xm       , Md^Xm       , Md^Xm       , Md^Xm       , Md^Xm       , Ds          , Ds          , Hd          , Hd          , Ds          , Ds          , Dd          , Dd          , Dd          , Dd          , Ds          , Dd          , Ds          , Ds          , Ds          , Ds          , Ds          , Ds          , Md^Xm       , Md^Xm       , Md^Xm       , Ds          , Md^Xm       , Ds          , Md^Xm       , Md^Xm       , Ds          , Ds          , Ds          , Ds          , Ds          , Ds          , Ds          , Ds          , Ds          , Ds          , Dd          , Dd          , Dd          , Dd          , Ds          , Ds          , Ds          , Ds          , Ds          , Ds          , Ds          , Ch          , Ds          , Ch          , Ds          , Ds          , Ds          , Ds          , Ds          , Md^Xm       , Md^Xm       
Md^Xm       , Md^Xm       , Md^Xm       , Md^Xm       , Ds          , Ds          , Ds          , Hd          , Ds          , Hd          , Hd          , Ds          , Ds          , Dd          , Ds          , Dd          , Dd          , Ds          , Ds          , Ds          , Ds          , Ds          , Md^Xm       , Md^Xm       , Dd          , Dd          , Rr          , Rr          , Rr          , Ds          , Dd^Vdt      , Md^Xm       , Md^Xm       , Md^Xm       , Md^Xm       , Ds          , Ds          , Ds          , Ds          , Ds          , Ds          , Ds          , Ds          , Dd          , Ds          , Ds          , Ds          , Ds          , Ds          , Ds          , Ds          , Ch          , Ds          , Ch          , Ds          , Ch          , Ds          , Ds          , Ds          , Ds          , Md^Xm       , Md^Xm       
Md^Xm       , Md^Xm       , Md^Xm       , Md^Xm       , Ds          , Ds          , Ds          , Hd          , Ds          , Ds          , Ds          , Ds          , Ds          , Ds          , Dd          , Dd          , Dd          , Ds          , Md^Xm       , Md^Xm       , Md^Xm       , Md^Xm       , Dd^Vdt      , Dd          , Dd^Vda      , Rr          , Gs^Ft       , Gs^Ft       , Gs^Ft       , Rr          , Rr          , Ds          , Dd^Do       , Ds          , Ch          , Md^Xm       , Md^Xm       , Ds          , Ds          , Ds          , Ds          , Ds          , Ds          , Ds          , Ds          , Ds          , Ch          , Ch          , Ds          , Ds          , Gs          , Gs          , Rd          , Rd          , Ds          , Ds          , Gs^Ft       , Ds          , Ds          , Dd^Vda      , Md^Xm       , Md^Xm       
Ds          , Md^Xm       , Ds          , Ds          , Ce          , Ds          , Ds          , Ds          , Ds          , Ds          , Ds          , Ds          , Dd          , Dd          , Dd          , Dd          , Ds          , Ds          , Md^Xm       , Md^Xm       , Md^Xm       , Md^Xm       , Hd          , Hd          , Rr          , Rr          , Gs^Ft       , Gs^Ft       , Ww          , Gs^Ft       , Gs^Ft       , Rr          , Rr          , Ds          , Ch          , Rr          , Rr          , Md^Xm       , Ds          , Ds          , Hd          , Ds          , Hd          , Ds          , Ds          , Ch          , Rd          , Ds          , Gs          , Gs          , Gs          , Gs          , Rd          , Ds          , Gs^Ft       , Gs^Ft       , Gs^Ft       , Ds          , Ds          , Ds          , Md^Xm       , Md^Xm       
Ds          , Ds          , Ds          , Ce          , 1 Ke        , Ce          , Ds          , Ds          , Ds          , Ds          , Ds          , Ds          , Dd          , Dd          , Dd          , Dd          , Md^Xm       , Md^Xm       , Md^Xm       , Md^Xm       , Md^Xm       , Hd          , Rr          , Rr          , Gs^Ft       , Gs^Ft       , Ww          , Ww          , Ww          , Ww          , Ww          , Gs^Ft       , Gs^Ft       , Rr          , Rr          , Ch          , Rr          , Md^Xm       , Ds          , Ds          , Hd          , Hd          , Hd          , Ds          , Ds          , Ch          , Rd          , Ds          , Gs          , Gs^Vht      , Gs          , Ds          , Ds          , Gs^Ft       , Gs^Ft       , Gs^Ft       , Gs^Ft       , Gs^Ft       , Ds          , Md^Xm       , Md^Xm       , Md^Xm       
Ds          , Ds          , Ds          , Ce          , Ce          , Ce          , Ds          , Ds          , Ds          , Dd          , Dd          , Dd          , Dd          , Dd          , Ds          , Ds          , Md^Xm       , Md^Xm       , Md^Xm       , Md^Xm       , Md^Xm       , Hd          , Rr          , Gs^Ft       , Gs^Ft       , Ww          , Ww          , Ww          , Ww          , Ww          , Gs^Ft       , Gs^Ft       , Rr          , Rr          , Ds          , Ch          , Ch          , Md^Xm       , Ds          , Ds          , Hd          , Hd          , Hd          , Ds          , Ds          , Ch          , Ds          , Rd          , Rd          , Gs          , Ds          , Ds          , Gs^Ft       , Ds          , Ds          , Gs^Ft       , Ds          , Ds          , Md^Xm       , Md^Xm       , Md^Xm       , Md^Xm       
Ds          , Ds          , Ds          , Ds          , Ds          , Ds          , Dd          , Dd          , Dd          , Dd          , Dd          , Ds          , Ds          , Dd          , Ds          , Md^Xm       , Md^Xm       , Md^Xm       , Ds          , Ds          , Dd^Cd       , Dd^Cd       , Dd^Cd       , Rr          , Gs^Ft       , Ww          , Gs^Ft       , Ww          , Gs^Ft       , Gs^Ft       , Gs^Ft       , Gs^Ft       , Rr          , Dd          , Dd          , Dd          , Dd          , Md^Xm       , Md^Xm       , Ds          , Ds          , Hd          , Hd          , Ds          , Ds          , Ds          , Gg          , Ds          , Ds          , Ds          , Gs          , Gs^Ft       , Ww          , Rd          , Dd^Vda      , Ds          , Ds          , Ch          , Ch          , Md^Xm       , Md^Xm       , Md^Xm       
Ds          , Ds          , Ds          , Ds          , Ds          , Ds          , Ds          , Dd          , Dd          , Dd          , Dd          , Ds          , Ds          , Dd          , Ds          , Md^Xm       , Md^Xm       , Md^Xm       , Ds          , Ds          , Dd^Cd       , 6 Dd^Kd     , Dd^Cd       , Rr          , Rr          , Gs^Ft       , Rr          , Gs^Ft       , Rr          , Rr          , Rr          , Rr          , Dd          , Dd          , Ds          , Dd^Vda      , Ds          , Ds          , Md^Xm       , Ds          , Dd          , Ds          , Ds          , Ds          , Ds          , Gg          , Gg          , Gg          , Ds          , Gs^Ft       , Ww          , Ww          , Ww          , Gs^Ft       , Ds          , Ds          , Ch          , Ch          , 5 Kh        , Md^Xm       , Md^Xm       , Md^Xm       
Ds          , Ds          , Ds          , Ds          , Ce          , Ds          , Ds          , Dd          , Dd          , Dd          , Dd          , Ds          , Ds          , Ds          , Ds          , Md^Xm       , Md^Xm       , Md^Xm       , Ds          , Ds          , Ds          , Dd^Cd       , Md^Xm       , Hd          , Hd          , Rr          , Hd          , Rr          , Ds          , Dd          , Dd          , Dd          , Dd          , Dd          , Md^Xm       , Ds          , Md^Xm       , Md^Xm       , Md^Xm       , Dd          , Dd          , Dd          , Dd          , Ds          , Ds          , Gg          , Gg^Ve       , Gg          , Ds          , Ww          , Ww          , Ww          , Ww          , Gs^Ft       , Rd          , Ds          , Rd          , Ch          , Md^Xm       , Md^Xm       , Md^Xm       , Md^Xm       
Md^Xm       , Ds          , Ds          , Ce          , 2 Ke        , Ce          , Ds          , Dd          , Dd          , Dd          , Dd          , Ds          , Ds          , Hd          , Hd          , Md^Xm       , Md^Xm       , Md^Xm       , Md^Xm       , Ds          , Ds          , Ds          , Md^Xm       , Md^Xm       , Md^Xm       , Dd^Vdt      , Hd          , Ds          , Md^Xm       , Dd          , Dd          , Dd          , Md^Xm       , Md^Xm       , Md^Xm       , Md^Xm       , Ds          , Md^Xm       , Ds          , Ds          , Dd          , Dd          , Dd          , Ds          , Ds          , Gg          , Gg          , Gg          , Ds          , Gs^Ft       , Gs^Ft       , Gs^Ft       , Ds          , Ds          , Ds          , Rd          , Ds          , Ch          , Md^Xm       , Md^Xm       , Md^Xm       , Md^Xm       
Md^Xm       , Md^Xm       , Md^Xm       , Ce          , Ce          , Ce          , Ds          , Ds          , Ds          , Dd          , Dd          , Ds          , Ds          , Hd          , Hd          , Hd          , Hd          , Md^Xm       , Md^Xm       , Md^Xm       , Md^Xm       , Ds          , Md^Xm       , Md^Xm       , Md^Xm       , Hd          , Md^Xm       , Md^Xm       , Md^Xm       , Md^Xm       , Md^Xm       , Md^Xm       , Md^Xm       , Md^Xm       , Dd          , Dd          , Dd          , Dd          , Dd          , Ds          , Dd          , Dd          , Dd          , Ds          , Ds          , Gg          , Ds          , Ds          , Rd          , Ds          , Ds          , Ds          , Ds          , Dd^Vdt      , Gs^Ft       , Gs^Ft       , Ww          , Ds          , Md^Xm       , Md^Xm       , Md^Xm       , Md^Xm       
Md^Xm       , Md^Xm       , Md^Xm       , Ds          , Ds          , Ds          , Ds          , Ds          , Ds          , Ds          , Ds          , Ds          , Ds          , Ds          , Hd          , Hd          , Ds          , Md^Xm       , Md^Xm       , Md^Xm       , Md^Xm       , Md^Xm       , Md^Xm       , Md^Xm       , Md^Xm       , Md^Xm       , Md^Xm       , Md^Xm       , Md^Xm       , Md^Xm       , Md^Xm       , Md^Xm       , Dd          , Ds          , Dd          , Dd          , Dd          , Dd          , Ds          , Ds          , Dd^Do       , Ds          , Ds          , Ds          , Ds          , Ch          , Ds          , Rd          , Rd          , Ds          , Gg          , Ds          , Rd          , Ds          , Gs^Ft       , Ww          , Ww          , Ww          , Ww          , Md^Xm       , Md^Xm       , Md^Xm       
Md^Xm       , Md^Xm       , Md^Xm       , Md^Xm       , Ds          , Ds          , Ds          , Hd          , Hd          , Ds          , Ds          , Dd          , Ds          , Ds          , Ds          , Ds          , Dd          , Md^Xm       , Md^Xm       , Md^Xm       , Md^Xm       , Md^Xm       , Ds          , Md^Xm       , Ds          , Md^Xm       , Dd          , Md^Xm       , Dd          , Dd          , Dd          , Dd          , Dd          , Ds          , Ds          , Dd          , Ds          , Ds          , Ds          , Ds          , Ds          , Ds          , Ds          , Ds          , Ds          , Ch          , Rd          , Rd          , Ds          , Ds          , Gg          , Ds          , Ds          , Rd          , Gs^Ft       , Ww          , Ww          , Ww          , Ww          , Ww          , Md^Xm       , Md^Xm       
Md^Xm       , Md^Xm       , Md^Xm       , Md^Xm       , Md^Xm       , Ds          , Ds          , Ds          , Hd          , Ds          , Ds          , Dd          , Dd          , Ds          , Ds          , Dd          , Dd          , Dd          , Dd          , Ds          , Hd          , Ds          , Ds          , Ds          , Dd          , Dd          , Dd          , Dd          , Dd          , Dd          , Dd          , Dd^Vdt      , Ds          , Ds          , Ds          , Ds          , Ds          , Ds          , Hd          , Hd          , Hd          , Hd          , Ds          , Ds          , Ds          , Ch          , Ch          , Ds          , Gg          , Gg          , Gg          , Gg          , Ds          , Rd          , Gs^Ft       , Ww          , Ww          , Ww          , Gs^Ft       , Gs^Ft       , Gs^Ft       , Md^Xm       
Md^Xm       , Md^Xm       , Md^Xm       , Md^Xm       , Md^Xm       , Md^Xm       , Ds          , Ds          , Hd          , Hd          , Ds          , Ds          , Ds          , Dd          , Dd          , Dd          , Dd          , Dd          , Ds          , Ds          , Hd          , Hd          , Ds          , Ds          , Ds          , Dd          , Ds          , Dd          , Ds          , Dd          , Ds          , Ds          , Dd^Cd       , Dd^Cd       , Ww          , Ds          , Ds          , Ds          , Ds          , Hd          , Hd          , Hd          , Ds          , Ds          , Ds          , Ds          , Ds          , Ch          , Gg          , Gg^Vh       , Gg          , Gg          , Ch          , Rd          , Ch          , Gs^Ft       , Gs^Ft       , Gs^Ft       , Gs^Ft       , Gs^Ft       , Ds          , Md^Xm       
Md^Xm       , Md^Xm       , Md^Xm       , Md^Xm       , Md^Xm       , Md^Xm       , Md^Xm       , Ds          , Ds          , Hd          , Hd          , Ds          , Dd^Do       , Dd          , Dd          , Dd          , Dd          , Dd          , Ds          , Ds          , Hd          , Hd          , Hd          , Ds          , Hd          , Ds          , Ds          , Dd^Fi       , Ds          , Ds          , Dd^Cd       , Dd^Cd       , Ww          , Ww          , Ww          , Gs^Ft       , Ds          , Dd^Vda      , Ds          , Ds          , Ds          , Hd          , Hd          , Ds          , Dd          , Ds          , Dd          , Ds          , Ds          , Ds          , Ds          , Ch          , Ds          , Ch          , Ds          , Ch          , Dd          , Dd          , Dd          , Ds          , Md^Xm       , Md^Xm       
Md^Xm       , Md^Xm       , Md^Xm       , Md^Xm       , Md^Xm       , Md^Xm       , Md^Xm       , Ds          , Ds          , Ds          , Ds          , Ds          , Ds          , Dd          , Dd          , Dd          , Ds          , Ds          , Ds          , Ds          , Hd          , Hd          , Hd          , Hd          , Hd          , Ds          , Ds          , Ds          , Ds          , Ds          , Dd^Cd       , 4 Dd^Kd     , Ww          , Ww          , Ww          , Gs^Ft       , Ds          , Ds          , Dd          , Dd          , Ds          , Hd          , Ds          , Ds          , Dd          , Dd          , Dd          , Dd          , Dd          , Ds          , Ds          , Ds          , Ds          , Ds          , Ds          , Ds          , Dd          , Dd          , Ds          , Ds          , Md^Xm       , Md^Xm       
Md^Xm       , Md^Xm       , Md^Xm       , Md^Xm       , Md^Xm       , Md^Xm       , Ds          , Ds          , Ds          , Ds          , Ds          , Ds          , Ds          , Dd          , Dd          , Dd          , Ds          , Ds          , Ds          , Ds          , Ds          , Ds          , Ds          , Ds          , Ds          , Ds          , Ds          , Ds          , Ds          , Ds          , Dd^Cd       , Gs^Ft       , Ww          , Ww          , Gs^Ft       , Gs^Ft       , Dd          , Dd          , Dd          , Dd          , Ds          , Ds          , Ds          , Ds          , Ds          , Dd          , Dd          , Dd          , Dd          , Ds          , Ds          , Ds          , Ds          , Ds          , Ds          , Dd          , Ds          , Dd          , Ds          , Md^Xm       , Md^Xm       , Md^Xm       
Md^Xm       , Md^Xm       , Md^Xm       , Md^Xm       , Md^Xm       , Md^Xm       , Md^Xm       , Ds          , Ds          , Ds          , Ds          , Ds          , Ds          , Ds          , Ds          , Ds          , Ds          , Md^Xm       , Md^Xm       , Ds          , Ds          , Ds          , Ds          , Ds          , Ds          , Ds          , Ds          , Dd^Vdt      , Ds          , Ds          , Ds          , Gs^Ft       , Gs^Ft       , Gs^Ft       , Ds          , Gs^Ft       , Ds          , Dd          , Dd          , Dd          , Ds          , Ds          , Md^Xm       , Md^Xm       , Ds          , Ds          , Ds          , Dd          , Ds          , Ds          , Hd          , Ds          , Hd          , Hd          , Hd          , Ds          , Ds          , Ds          , Md^Xm       , Md^Xm       , Md^Xm       , Md^Xm       
Md^Xm       , Md^Xm       , Md^Xm       , Md^Xm       , Md^Xm       , Md^Xm       , Md^Xm       , Ds          , Ds          , Ds          , Ds          , Ds          , Md^Xm       , Ds          , Md^Xm       , Md^Xm       , Md^Xm       , Md^Xm       , Md^Xm       , Md^Xm       , Md^Xm       , Md^Xm       , Md^Xm       , Ds          , Ds          , Ds          , Ds          , Ds          , Ds          , Ds          , Md^Xm       , Ds          , Md^Xm       , Ds          , Md^Xm       , Ds          , Ds          , Ds          , Ds          , Ds          , Ds          , Ds          , Md^Xm       , Md^Xm       , Md^Xm       , Ds          , Md^Xm       , Ds          , Ds          , Ds          , Ds          , Hd          , Hd          , Hd          , Ds          , Ds          , Ds          , Md^Xm       , Md^Xm       , Md^Xm       , Md^Xm       , Md^Xm       
Md^Xm       , Md^Xm       , Md^Xm       , Md^Xm       , Md^Xm       , Md^Xm       , Md^Xm       , Md^Xm       , Md^Xm       , Md^Xm       , Md^Xm       , Md^Xm       , Md^Xm       , Md^Xm       , Md^Xm       , Md^Xm       , Md^Xm       , Md^Xm       , Md^Xm       , Md^Xm       , Md^Xm       , Md^Xm       , Md^Xm       , Md^Xm       , Md^Xm       , Md^Xm       , Md^Xm       , Md^Xm       , Md^Xm       , Md^Xm       , Md^Xm       , Md^Xm       , Md^Xm       , Md^Xm       , Md^Xm       , Md^Xm       , Md^Xm       , Md^Xm       , Md^Xm       , Md^Xm       , Md^Xm       , Md^Xm       , Md^Xm       , Md^Xm       , Md^Xm       , Md^Xm       , Md^Xm       , Md^Xm       , Md^Xm       , Md^Xm       , Md^Xm       , Md^Xm       , Md^Xm       , Md^Xm       , Md^Xm       , Md^Xm       , Md^Xm       , Md^Xm       , Md^Xm       , Md^Xm       , Md^Xm       , Md^Xm       
